NO textures/wall.xpm
EA textures/wall.xpm
SO textures/wall.xpm
WE textures/wall.xpm

C 148, 0, 128
F 0, 0, 0

111111111111111
110000000111111
1101100N0011111
110100000001111
110001111100111
110010101010011
101111111111101
110000111000011
111000010000111
111100010001111
111110010011111
111111000111111
111111111111111

